1111111011111
10011000001C1
0000011111011
1P0011E000010
1101111101110