1111111111111
1E01000000C01
1100011111001
1C0C110P00001
1111111111111